1111111111111
1001000CCCCC1
1E00011111001
1P0011E000001
1111111111111
